########################################
#......................................#
#..P.......==............~~~~~~........#
#..........==............~~~~~~........#
#..........==..................^^^^^^^^#
#..........==..................^^^^^^^^#
#..........==...C..............^^^^^^^^#
#..........==..................^^^^^^^^#
#..........==..................^^^^^^^^#
#..........==...T..............^^^^^^^^#
#..........==..................^^^^^^^^#
#..........==..................^^^^^^^^#
#..........==..................^^^^^^^^#
#..........==..................^^^^^^^^#
#..........==..................^^^^^^^^#
#..........==..................^^^^^^^^#
#..........==..................^^^^^^^^#
#..........==..................^^^^^^^^#
#..........==..................^^^^^^^^#
########################################